HHHHHHHHHHHHHHHHHHHHHHHHHHHHHHHHHHHHHHHHHHHHHHHHHHHHHHHHHHHHHHHHHHHHHHHHHHHHHHHHHHHHHHH
H.....................................................................................H
H.....................................................................................H
H.....................................................................................H
H.....................................................................................H
H.....................................................................................H
H.....................................................................................H
H.....................................................................................H
H.....................................................................................H
H.....................................................................................H
H.....................................................................................H
H.....................................................................................H
H.....................................................................................H
H.....................................................................................H
H.....................................................................................H
H.....................................................................................H
H.....................................................................................H
H.....................................................................................H
H.....................................................................................H
H.....................................................................................H
H.....................................................................................H
H.....................................................................................H
H.....................................................................................H
H.....................................................................................H
H.....................................................................................H
H.....................................................................................H
H.....................................................................................H
H.....................................................................................H
H.....................................................................................H
H.....................................................................................H
H.....................................................................................H
H.....................................................................................H
H.....................................................................................H
H.....................................................................................H
H.....................................................................................H
H.....................................................................................H
H.....................................................................................H
H.....................................................................................H
H...HHHHHHHHHHHHHHHHHHHHHHHHHHHHHH....................................................H
H...H............................H....................................................H
H...H............................H....................................................H
H...H..O.........................H....................................................H
H...H............................H....................................................H
H...H............................H....................................................H
H...H............................H...............p....................................H
H...H............................H....................................................H
H...HHHHHHHHHHHHHHHHH.....HHHHHHHH....................................................H
H.....................................................................................H
H.....................................................................................H
H.....................................................................................H
HHHHHHHHHHHHHHHHHHHHHHHHHHHHHHHHHHHHHHHHHHHHHHHHHHHHHHHHHHHHHHHHHHHHHHHHHHHHHHHHHHHHHHH

